1111111111111111111111111111111111
1E0000000000P00C00000C0000000C0001
1010010100100000101001000C00010101
101C010010101010C01001000000010101
100000000000C0000000000C00000000C1
1111111111111111111111111111111111
