1111111111111
1001C00C000C1
10000111110P1
100011E0C00C1
1111111111111
