1111111111111
100100000C001
1P00011111001
100011000E001
1111111111111
